% Unidade 1
Bus: onibus, barramento;
Bug: inseto, problema;
Bike: bicicleta;
Bag: bolsa, mochila;
Ball: bola, esfera;
Book: livro;
Boat: barco;
Box: caixa;
Bell: sino;
Bird: passaro;
% Unidade 2
Bicycle: bicicleta;
Ball: bola, esfera;
Book: livro;
Bridge: ponte;
Bottle: garrafa;
Brush: escova;
Bread: pao;
Brick: tijolo;
Branch: galho, ramo;
Bench: banco;
% Unidade 3
Cat: gato;
Cup: xicara, copo;
Car: carro, automovel;
Chair: cadeira;
Cow: vaca;
Clock: relogio;
Cloud: nuvem;
Coat: casaco;
Castle: castelo;
Circle: circulo;
% Unidade 4
Dog: cachorro, cao;
Door: porta;
Desk: mesa, escrivaninha;
Doll: boneca;
Duck: pato;
Dish: prato;
Doctor: medico;
Dream: sonho;
Drum: tambor;
Diamond: diamante;
% Unidade 5
Elephant: elefante;
Eye: olho;
Egg: ovo;
Engine: motor;
Eagle: aguia;
Earth: terra, mundo;
Envelope: envelope;
Elevator: elevador;
Energy: energia;
Exit: saida;
% Unidade 6
Fish: peixe;
Fire: fogo;
Flower: flor;
Forest: floresta;
Field: campo;
Finger: dedo;
Flag: bandeira;
Farm: fazenda;
Fence: cerca;
Fan: ventilador;
% Unidade 7
Game: jogo;
Glass: vidro, copo;
Garden: jardim;
Gift: presente;
Gate: portao;
Gold: ouro;
Guitar: guitarra, violao;
Goose: ganso;
Grass: grama;
Glove: luva;
% Unidade 8
House: casa;
Horse: cavalo;
Hat: chapeu, bone;
Hill: colina;
Heart: coracao;
Honey: mel;
Hammer: martelo;
Hut: cabana;
Holiday: ferias;
Hero: heroi;
% Unidade 9
Ice: gelo;
Idea: ideia;
Island: ilha;
Ink: tinta;
Iron: ferro;
Image: imagem;
Instrument: instrumento;
Item: item;
Ivory: marfim;
Illusion: ilusao;
% Unidade 10
Jacket: jaqueta;
Jungle: selva;
Juice: suco;
Jewel: joia;
Journey: viagem;
Job: trabalho;
Jam: geleia;
Justice: justica;
Joke: piada;
Jump: salto, pulo;
% Unidade 11
Kite: pipa;
Kitchen: cozinha;
Key: chave;
Knife: faca;
King: rei;
Koala: coala;
Knee: joelho;
Knowledge: conhecimento;
Keyboard: teclado;
Kid: crianca;
% Unidade 12
Lion: leao;
Lamp: lampada;
Lake: lago;
Leaf: folha;
Letter: carta;
Ladder: escada;
Lemon: limao;
Light: luz;
Line: linha;
Lighthouse: farol;
% Unidade 13
Moon: lua;
Mountain: montanha;
Music: musica;
Mirror: espelho;
Mouse: rato;
Milk: leite;
Market: mercado;
Map: mapa;
Moment: momento;
Machine: maquina;
% Unidade 14
Notebook: caderno, notebook;
Nest: ninho;
Number: numero;
Name: nome;
Net: rede;
Neck: pescoco;
Night: noite;
Nail: prego, unha;
News: noticia;
Needle: agulha;
% Unidade 15
Ocean: oceano;
Orange: laranja;
Owl: coruja;
Oil: oleo;
Opera: opera;
Order: pedido, ordem;
Office: escritorio;
Offer: oferta;
Option: opcao;
Owner: proprietario;
% Unidade 16
Pen: caneta;
Pencil: lapis;
Paper: papel;
Phone: telefone;
Piano: piano;
Plate: prato;
Plant: planta;
Pool: piscina;
Plane: aviao;
Picture: quadro, imagem;
% Unidade 17
Queen: rainha;
Quilt: colcha;
Question: pergunta;
Quick: rapido;
Quiet: silencio;
Quiver: aljava;
Quarter: quarto, moeda;
Quality: qualidade;
Quote: citação;
Quest: busca, missao;
% Unidade 18
River: rio;
Rain: chuva;
Road: estrada;
Rock: pedra, rocha;
Ring: anel;
Rabbit: coelho;
Roof: telhado;
Rose: rosa;
Radio: radio;
Room: quarto;
% Unidade 19
Sun: sol;
Star: estrela;
Stone: pedra;
Ship: navio;
Shirt: camisa;
Shadow: sombra;
Shoes: sapatos;
School: escola;
Story: historia;
Sand: areia;
% Unidade 20
Tree: arvore;
Table: mesa;
Tiger: tigre;
Train: trem;
Tower: torre;
Track: trilho, trilha;
Ticket: ingresso;
Travel: viagem;
Tail: cauda, rabo;
Tunnel: tunel;